Anjalankosken Judo
Arashi=ARA>Loviisa
Asahi
Bodonos=BOD>Kerava
Budokan=BUD>Vaasa
Budokwai
Budoviikingit=BDV>Helsinki
Byakuya=BYA>Sodankylä
Chikara=CHI>Helsinki
Darmakai=DAR>Laukaa
Enbukan=ENB>Pietarsaari
Espoon Judokerho=EJK
Espoon Urheilijat=ESU
Finndai=FND>Helsinki
Fojudo
Forssan Alku
Fudoshin=FUD>Pori
Fuguda=FUG>Karjaa
Hämeenkosken Judo
Hämeenlinnan JS=HÄM
Hachigatsu
Haminan Judoseura=HAM
Hauve-kan=HAU>Haukipudas
Holjutai=HOL>Hollola
Hontai Judo=HON>Helsinki
Hyrysalmen Judokat
Hyvinkään Judoseura=HYV
Iisalmen Judoseura=IIS
Ippon=IPP>Loimaa
Jämsän Yoshi=JÄM
Järvenpään Akagi=AKA
Jigogu=JGO>Lieksa
Jigotai=JIG>Jyväskylä
Joen Yawara=YAW>Joensuu
Joutsan Tarmo=JOU
Judo Club Raahe=JCR
Judo-Kan=JDK>Espoo
Judoseura Koshado=KOS>Kaavi
Judoviikingit
Jukata=JKT>Mäntsälä
Ju Shin Kan=JUS>Ähtäri
Kaarinan Urheilijat=KAA
Kabudo=KAB>Karstula
Kaigan=KAI>Rauma
Kajaanin Judokerho=KAJ
Kalajoen Judoklubi
Kamiza=KAM>Lappeenranta
Kankaanpään Judokat=KAN
Kärkälän Kisa-Judo
Kashi-no-kai
Katana=KAT>Kangasniemi
Kauhajoen Karhu=KAU
Kaustisen Pohjan-Veikot=KPV
Kazoku
Keido-kan=KEI>Siuntio
KeJuBo=KEU>Keuruu
Kerimäen Judonoko=KER
Kestilän Kisa-Veikot=KES
Kippon=KIP>Kitee
Kirkkonummen JS=KIR
Kita-Kan=KIT>Kemi
Kokkai-Kan=KOK>Tornio
Kokkolan Budo=KBU
Kotkan Judoseura=KOT
Koulujudo=KOJ
Kouvolan Judoseura=KOU
Koyama=KOY>Rovaniemi
Kristiinan Seudun Judo
Kuttulan Judo=KUT>Mäntyharju
Kuusankosken JS=KUU
Lahden Judoseura=LAH
Lahden Urheilukoulu
Lammin Judoseura=LAM
Lappajärven Veikot=LPV
Lohjan Urheilijat=LOH
Loviisan Judokat
Mäntyharjun Judo=MÄN
Maskun Tempo=MAS
Meidokan=MEI>Helsinki
Mikkelin Judo=MIK
Nummelan Judo=NUM
Nokian Judo=NOK
Numa-no-kai=NNK>Suolahti
Oka-Doo
Orimattilan JS=ORI
Oriveden JS Wakaido
Oulun Judokerho=OJK
Pellon Judoseura=PEL
Pikadon=PIK>Pieksamäki
Pingviinit=PIN>Nurmijärvi
Pirkkalan Judokerho=PIR
Popinniemen Isku=POP>Kotka
Punkaharjun Judo=PNK
Punkalaitumen Kunto=PUN
Pyhäjärven Judo
Raahen Judo=RAA
Raision Ryhti=RAI
Rauman JS Samurai=RAU
Riihimäen Judoseura=RII
Ryo-do-kai
Sakura=SAK>Kuopio
Salon Budoseura=SAL
Samurai=SAM>Valkeakoski
Savitaipaleen JS
Savonlinnan Shikata=SAV
Seibukan=KUR>Kurikka
Seinäjoen Judoseura=SEI
Shinrai=SNR>Pirkkala
Shirakaba
Shiranami=SRA>Lapinlahti
Shirokawa=SRO>Porvoo
Shogun=SHO>Espoo
Shudokan
Sobudo=SOB>Somero
Soinin Sisu/Shinmeikan=SHI
Sotkamon Tsuyoi=TSU>Vuokatti
Sukoshi=SUK>Imatra
Suomen kamppailu-ur.=SKU
Tampereen Judo=TRE
Tapanilan Erä=TAP>Helsinki
Tatakai
Tikkurilan Judokat=TIK>Vantaa
TNS-Judo=TNS>Toijala
Tomodachi=KJT>Kuopio
Toodokan
Tsukuri=TSK>Hanko
Tsunami=TSA>Nurmes
Turun Judoseura=TUR
Vantaan Jukara=JKR
Vihannin Judo=VIH
Virtain U/Seidokan
Waseda-Club=WAC>Uusikaupunki
Waza-Aite
Yama-Arashi=YAM>Varkaus
Yanagi=YAG>Heinävesi
Zenjudo=ZEN>Naantali
Ålands Judoklubb=ÅJK>Maarianhamina
Heinolan Judoseura=HEI
Himangan Judoseura=HIM
Ilomantsin Toroo-kai=ILO
Kristiinankaupungin ja Närpiön Judo=KRS
Savukosken Kuohu=KUO
OYUS Judo=OYJ>Oulu
Skärgårdens Judoklubb=ROS>Rosala
Sarko=SAR>Turku
Suomenlinnan urheilijat=SUO>Helsinki
Pyhäsalmen Sykkeen Judo=SYK
Vammalan Veikot=VAM
